流行を超える	の	一過性の
学習を繰り返す	や	開発や
コンテンツ生成を行う	という	CreativeAIという
開発を行う	の	機械式計算機の
投資全額を上回る	の	政府の
研究を進める	の	第五世代コンピュータの
注目を集める	の	世間の
成功を受ける	の	試みの
知的制御を用いる	の	同様の
進歩を担う	の	科学技術の
精度改善を果たす	から	従来手法からの
専用プログラムを使う	にあたる	解析にあたる
関連性を導き出す	の	情報の
認識能力を持つ	の	人間並みの
注目を集める	の	識者の
普及を受ける	と	発明と
機械学習を組み合わせる	と	神経科学と
研究を行う	という	再構成するという
実験をする	や の	研究や 新技術の
弾圧を併せ持つ	と の	資金力と 人権の
監視社会化を恐れる	による	人工知能による
差別を認める	のみ で	ビッグデータ分析のみによる、 融資での
展開を変える	の	部隊の
判断を介す	の	人間の
禁止を求める	の	自動操縦型武器の
運用をめぐる	の	AI兵器の
自律無人艇を使う	の	56隻の
試験を行う	の	世界最大規模の
話をする	の	異界の
